111111111111111
1P0000000000001
1C0000C110000E1
111111111111111