1111111111111
1P00000100001
1000000000001
1000000000001
1C0000C1100E1
1111111111111