1111111111111
1P00100100001
1110000000001
1C000000E0001
10000M0000101
1000000000001
1000000010101
1111111011111
1111111011111
1000100000001
1110000000001
1C000000E0001
10000M0000101
1000000000001
1000000110101
1111101111111
1111101111111
1000100100001
1110000000001
1C000000E0001
10000M0000101
1000000000001
1000000110101
1011111111111
1111111111111