111111111111111
1P0000010000001
100000000000001
1C0000C110000E1
111111111111111