1111111111111
1P00100100001
1110000000001
1000000000001
1000000000101
1000000000001
1C0000C1101E1
1111111111111