1111111111111
1P0C100100001
11v0000000001
1C000000E0001
10000M0C00101
100000v000001
10000001101E1
1111111111111