1111111111111
1P0C100100001
1110000000001
1C000000E0001
10000M0000101
10h0000000001
1000000110101
1111111111111