1111111111111
1P00100100001
1110000000001
10000000E0001
10000M0000101
1000000000001
1000000110101
1111111111111