1111111111111111111111111111
11111111000000000000000001C1
1100E00100000000000000010101
1101010100011110000000010101
110101010001CP10000000010101
1111011100010010000000010001
100M000000000000000000011111
1000000000000000000000000001
1000000000000000000000000001
1000000011111100000000000001
100000001CCCC10000000000M001
1000000010000100011111111101
100000001M00010001C000000001
1C00M00000000000011111111111
1111111111111111111111111111