1111111111111
1PCC1CC1CCCC1
111CCCCCCCCC1
1CCCCCCCECCC1
1CCCCM0CCC1C1
1CCCCCCCCCCC1
1CCCCCC11C1C1
1111111111111