1111111111111
1P0C100100001
1110000000001
1C000000E0001
10000M0000101
1000000000001
1P00000110101
1111111111111