111111111111111111111111111111
1111111100000000000000000001C1
1100E0010000000000000000010101
110101010000011110000000010101
11010101000001CP10000000010101
111101110000010010000000010001
10M000000000000000000000011111
100000000000000000000000000001
1000000000000000000000M0000001
100000011000000000000000000001
100000011011111100000000000001
10000000001CCCC100000000000001
100000000010000100011111111101
10000000001M00010001C000000101
100000000000000000011111110101
100000000000000M00000000000101
100M00000000000000011111111101
1000000000000000000000000M0001
1C00000000000000000000000000C1
111111111111111111111111111111